1111111111111111
1000000000000001
100000P000000001
1000000111110001
1000000100110001
1000000000010001
1000000100110001
1000000111110001
1000000000000001
1000000000000001
1000000000000001
1000000000000001
1000000000000001
1111111111111111