1000000000000001
        1111111111101111
1000000000000001
1000000111110001
1000000100110001
1000000000010001
1000000100110001
1000000111110001
1000000000000001
10000000P0000001
1000000000000001
1000000000000001
1000000000000001
1111111111111111