1111111111
1000000P11
1011001111
1000000101
1001011001
1001100001
1001100111
1111111111