1111111111
1000000001
1000000001
1000000101
1000011001
1000000001
100000P001
1111111111