
       WE ./mandatory/parse/assets/west.xpm
       NO ./mandatory/parse/assets/north.xpm
       EA ./mandatory/parse/assets/east.xpm
       SO ./mandatory/parse/assets/south.xpm

       F    41		,   36,   60
       C 25 ,	    35,     38


1111111111111111
100000100000001
100001111111111111111 111
10000011000000000000010001
10000010000000000000000001
10000011000000000000010001
11101111111011111111110001
110000110000001      10001
100000010000001     10001
100000010000001      10001
10000000000000111111111011111111111
10000001000000100000000000000000001
100000010000001000000000000000000001111
110000110000001001110000000000110010001
111111111111111001000000000000010010001
              10000000N0000111000010001
              1000000000000001000010001
              1000000100000111000000001
              1000001000001000000010001
              1000000100000000000010001
              1001000000100010010010001
              1001100000000001100100001
              1000000000001000000010001
              1000000000000000000010001
              1111111111111111111110001
                                  10001
                                  11111




